############S.############
############..############
##......................##
##......................##
##......................##
##......................##
##.....############.....##
##......................##
##......................##
#######............#######
##......................##
##..........P...........##
##.....############.....##
##......................##
##......................##
#######............#######
############FF############
############..############