############S.############
############..############
##......................##
##......................##
##.........####.........##
##......................##
##......................##
##..########..########..##
##......................##
##......................##
#######.....##.....#######
###....................###
###.........P..........###
###......########......###
###....................###
###....................###
############FF############
############..############