############S.############
############..############
##......................##
##......................##
##......................##
##......##########......##
##......................##
##......................##
#######............#######
##......................##
##......P...............##
##....#####....#####....##
##......................##
##......................##
######.....####.....######
######..##########..######
######FF##########FF######
######..##########..######